

SO ./textures/val/wall_s.xpm
WE ./textures/val/wall_w.xpm
NO ./textures/val/wall_n.xpm
EA ./textures/val/wall_e.xpm


F 220,100,0
C 225,30,0

DOOR ./textures/val/door.xpm
FLOOR ./textures/val/floor.xpm
CEIL ./textures/val/ceilling.xpm
GUN ./textures/val/gunz.xpm


11111111111111111111111111111111111111111111111111111111111111111111111111111111
11000000000000000000000000000000000000000000000000000000000001100000000000000001
10000000000000000000000000000000000000000000000000000000000000000000000000000001
10000001100000000000000000000000000000000000000000000000000000000000000011000001
10000000000000000000000000000000000000000000000000000000000000001000000000000001
10000001000000000000000000000000000000000000000000000000000000001000010101111111
10000000000000000000000000000000100000000000000000000000000000001000000000000001
10000000000000000000000000000000100000000000000000000000000000001000000000000001
10000000000000000000000000000000100000000000000000000000000000001100000000000001
10000000000000000000000000000000100000000000000000000000000000001000000000011001
10000000000000000000000000000000100000000000000000000000000000001000000000000001
100010000000Z0000000000000000000100000000000000000000000000000001000000000000001
10000000000000000000000000000000100000000000000000000000000000010000000000000001
10000000000000000000000000000000100000000000000000000000000000100000000000000001
10000110000000000000000000000000100000000000000000000000000001000000000000000001
10000000000000000000000Z00000000100000000000000000000000000010000000000000000001
1000000000000000000000000000Z000100000000000000000000000000000000000000000000001
10000001100000000000000000000000100000000000000000000000000000000000000011000001
10000000000000000000000000000000100000000000000000000000000000001000000000000001
10000001000000000000000000000000100000000000000000000000000000001000010101111111
10000000000000000000000000000000100000000000000000000000000000001000000000000001
100000000000000Z0000000N00000000100000000000000000000000000000001000000000000001
10000000000000000000000000000000100000000000000000100000000000001100000000000001
10000000000000000000000000000000100000000000000000100000000000001000000000011001
10000000000000000000000000000000100000000000000000100000000000001000000000000001
10000000000000000000Z00000000000100000000000000000100000000000001000000000011001
10000000000000000000000000000000100000000000000000100000000000001000000000000001
10001000000000000000000000000000100000000000000000100000000000001000000000000001
10000000000000000Z0000000000Z000100000000000000000100000000000010000000000000001
10000000000000000000000000000000100000000000000000100000000000100000000000000001
10000110000000000000000000000000100000000000000000100000000001000000000000000001
10000000000000000000000000000000000000000000000000100000000010000000000000000001
10000000000000000000000000000000000000000000000000100000000000000000000000000001
10000001100000000000000000000000000000000000000000100000000000000000000011000001
10000000000000000000000000000000000000000010000000100000000000001000000000000001
10000001000000000000000000000000000000000010000000100000000000001000010101111111
10000000000000000000000000000000000000000010000000100000000000001000000000000001
10000000000000000000000000000000000000000010000000100000000000001000000000000001
10000000000000000000000000000000000000000010000000100000000000001100000000000001
10000000000000000000000000000000000000000010000000100000000000001000000000011001
10000000000000000000000000000000000000000010000000100000000000001000000000000001
1000000000000000000Z00000000000000000000001000Z000100000000000001000000000011001
10000000000000000000000000000000000000000010000000100000000000001000000000000001
10001000000000000000000000000000000000000010000000100000000000001000000000000001
10000000000000000000000000000000000000000010000000100000000000010000000000000001
10000000000000000000000000000000000000000010000000100000000000100000000000000001
10000110000000000000000000000000000000000010000000100000000001000000000000000001
10000000000000000000000000000000000000000010000000000000000010000000000000000001
10000000000000000000000000000000000000000010000000000000000000000000000000000001
10000001100000000000000000000000000000000010000000000000000000000000000011000001
10000000000000000000000000000000000000000010000000000000000000001000000000000001
10000001000000000000000000000000000000000010000000000000000000001000010101111111
10000000000000000000000000000000000000000010000000000000000000001000000000000001
10000000000000000000000000000000000000000010000000000000000000001000000000000001
10000000000000000000000000000000000000000010000000000000000000001100000000000001
10000000000000000000000000000000000000000010000000000000000000001000000000011001
10000000000000000000000000000000000000000010000000000000000000001000000000000001
10001000000000000000000000000000000000000010000000000000000000001000000000000001
10000000000000000000000000000000000000000010000000000000000000010000000000000001
10000000000000000000000000000000000000000000000000000000000000100000000000000001
10000110000000000000000000000000000000000000000000000000000001000000000000000001
10000000000000000000000000000000000000000000000000000000000010000000000000000001
10000000000000000000000000000000000000000000000000000000000000000000000000000001
10000110000000000000000000000000000000000000000000000000000000000000000000000001
10000110000000000000000000000000000000000000000000000000000000000000000000000001
10000000000000000000000000000000000000000000000000000000000000000000000000000001
11111111111111111111111111111111111111111111111111111111111111111111111111111111